10 10
5 5

2
2 2
4 2

XXXXXXXXXX
X,,,,,,,,X
X,,,,,,,,X
X,,,,,,,,X
X,,,,,,,,X
X,,,,X,,,X
X,,,,,,,,X
X,,,,,,,,X
X,,,,,,,,X
XXXXXXXXXX
