10 10
5 5
XXXXXXXXXX
X,,,,,,,,X
X,,,,,,,,X
X,,,,,,,,X
X,,,,,,,,X
X,,,,X,,,X
X,,,,,,,,X
X,,,,,,,,X
X,,,,,,,,X
XXXXXXXXXX
